RRRRRRRRRRRRRRRRRRRRRRRRRRRRRRRRRR
RRRRRRRRRRRRRRRR++RRRRRRRRRRRRRRRR
RRRRRRRRRRRRRRRR--RRRRRRRRRRRRRRRR
RRRRRRR/////////++/////////RRRRRRR
RRRRRRR///$/////--/$////>//RRRRRRR
RRRRRRR/////////++/////////RRRRRRR
RRRRRRR//////#RR--RRRRRRRRRRRRRRRR
RRRRRRR//////RRR++RRRRRRRRRRRRRRRR
RRRRRRR//////RRR--RRRRRRRRRRRRRRRR
RRRRRRR///$//RRR++RRRRRRRRRRRRRRRR
RRRRRRR//////RRR--RRRRRRRRRRRRRRRR
RRRRRRR//////#RR++RRRRRRRRRRRRRRRR
RRRRRRR/////////--/////////RRRRRRR
RRRRRRR///$/////++////$////RRRRRRR
RRRRRRR/////////--/////////RRRRRRR
RRRRRRRRRRRRRRRR++RR#//////RRRRRRR
RRRRRRRRRRRRRRRR--RRR//////RRRRRRR
RRRRRRRRRRRRRRRR++RRR//$///RRRRRRR
RRRRRRRRRRRRRRRR--RRR//////RRRRRRR
RRRRRRRRRRRRRRRR++RRR//////RRRRRRR
RRRRRRRRRRRRRRRR--RR#//////RRRRRRR
RRRRRRR///</////++/////////RRRRRRR
RRRRRRR///<//$//--/////$///RRRRRRR
RRRRRRR///</////++/////////RRRRRRR
RRRRRRRRRRRRRRRR--RRRRRRRRRRRRRRRR
RRRRRRRRRRRRRRRR++RRRRRRRRRRRRRRRR
RRRRRRRRRRRRRRRRRRRRRRRRRRRRRRRRRR

[start]
	direction = 180

[size]
	w = 34
	h = 27
	
[total]
	bronze = 15000
	silver = 20000
	gold = 30000

[time]
	max = 15000
	bronze = 10000
	silver = 8000
	gold = 6000
	
[whits]
	max = 4
	bronze = 3
	silver = 2
	gold = 1
	
[coins]
	bronze = 3
	silver = 5
	gold = 7
	
[complete]
	medal = 1